%%%%%%%%%
%.......%
%.P..%..%
%.%.....%
%.......%
%%%%%%%%%
